# 2024-12-11	フルネーム
＠しそ	●名前●・ゾーン/トータ・▼旧家名▼・オル・▲家名▲	短縮よみ	始祖のフルネーム
＠とうしゅ	●名前●・▲家名▲	短縮よみ	当主のフルネーム
＠むすこ	●名前●・ゾーン・▲家名▲	短縮よみ	息子のフルネーム
＠むすめ	●名前●・トータ・▲家名▲	短縮よみ	娘のフルネーム
＠ようし	●名前●・ゾーン・▲実家▲・アドティ・■養子先■	短縮よみ	養子(男)のフルネーム
＠ようじょ	●名前●・トータ・▲実家▲・アドティ・■養子先■	短縮よみ	養子(女)のフルネーム
＠だいいちふじん	●名前●・トータ・▲実家▲・フラオ・■嫁ぎ先■	短縮よみ	第一夫人のフルネーム
＠だいにふじん	●名前●・トータ・▲実家▲・アシス・■嫁ぎ先■	短縮よみ	第二夫人のフルネーム
＠だいさんふじん	●名前●・トータ・▲実家▲・リトゥン・■嫁ぎ先■	短縮よみ	第三夫人のフルネーム
＠だいいちはいぐうしゃ	●名前●・ゾーン・▲実家▲・ルトナ・■婿入り先■	短縮よみ	第一配偶者のフルネーム
＠だいにはいぐうしゃ	●名前●・ゾーン・▲実家▲・アシス・■婿入り先■	短縮よみ	第二配偶者のフルネーム
＠だいさんはいぐうしゃ	●名前●・ゾーン・▲実家▲・リトゥン・■婿入り先■	短縮よみ	第三配偶者のフルネーム
＠だいいちふくん	●名前●・ゾーン・▲実家▲・ルトナ・■婿入り先■	短縮よみ	第一配偶者のフルネーム
＠だいにふくん	●名前●・ゾーン・▲実家▲・アシス・■婿入り先■	短縮よみ	第二配偶者のフルネーム
＠だいさんふくん	●名前●・ゾーン・▲実家▲・リトゥン・■婿入り先■	短縮よみ	第三配偶者のフルネーム
＠つぇんと	ツェント・●名前●	短縮よみ	ツェントのフルネーム
＠おう	ツェント・●名前●	短縮よみ	ツェントのフルネーム
＠おうじ	●名前●・ゾーン・ツェント・●王の名前●	短縮よみ	王子のフルネーム
＠おうじょ	●名前●・トータ・ツェント・●王の名前●	短縮よみ	王女のフルネーム
＠あうぶ	●名前●・アウブ・■領地■	短縮よみ	アウブのフルネーム
＠りょうしゅ	●名前●・アウブ・■領地■	短縮よみ	アウブのフルネーム
＠ぎーべ	●名前●・▲家名▲・ギーベ・■ギーベ領■	短縮よみ	ギーベのフルネーム