# 2024-12-11	人名		Android版
あーでるべると	アーデルベルト	ja-JP
あいんりーべ	アインリーベ	ja-JP
あうれーりあ	アウレーリア	ja-JP
あぐにーた	アグニータ	ja-JP
あすと	アスト	ja-JP
あだるじーざ	アダルジーザ	ja-JP
あどるふぃーね	アドルフィーネ	ja-JP
あどれっと	アドレット	ja-JP
あなすたーじうす	アナスタージウス	ja-JP
あにか	アニカ	ja-JP
あひむ	アヒム	ja-JP
ある	アル	ja-JP
あるすてーで	アルステーデ	ja-JP
あるとぅーる	アルトゥール	ja-JP
あるのー	アルノー	ja-JP
あるぷぜんてぃ	アルプゼンティ	ja-JP
あるふりーだ	アルフリーダ	ja-JP
あれくしす	アレクシス	ja-JP
あんげりか	アンゲリカ	ja-JP
あんぜるむ	アンゼルム	ja-JP
あんどれあ	アンドレア	ja-JP
いーじどーる	イージドール	ja-JP
いぇにー	イェニー	ja-JP
いぇにふぁー	イェニファー	ja-JP
いえるあーと	イエルアート	ja-JP
いぇれみあす	イェレミアス	ja-JP
いぐなーつ	イグナーツ	ja-JP
いざなべるた	イザナベルタ	ja-JP
いすはいと	イスハイト	ja-JP
いずべるが	イズベルガ	ja-JP
いでぃりーぬ	イディリーヌ	ja-JP
いでりーな	イデリーナ	ja-JP
いどな	イドナ	ja-JP
いねす	イネス	ja-JP
いまぬえる	イマヌエル	ja-JP
いみる	イミル	ja-JP
いるぜ	イルゼ	ja-JP
いるむひるで	イルムヒルデ	ja-JP
いんご	インゴ	ja-JP
ゔぁいす	ヴァイス	ja-JP
ゔぁねっさ	ヴァネッサ	ja-JP
ゔぁらまりーぬ	ヴァラマリーヌ	ja-JP
ゔぃくとあ	ヴィクトア	ja-JP
ゔぃるふりーと	ヴィルフリート	ja-JP
ゔぃるま	ヴィルマ	ja-JP
ゔぃんげると	ヴィンゲルト	ja-JP
うーでりっく	ウーデリック	ja-JP
ゔぇるでくらふ	ヴェルデクラフ	ja-JP
ゔぇろーにか	ヴェローニカ	ja-JP
ゔぇんとぅひーて	ヴェントゥヒーテ	ja-JP
ゔぉるふ	ヴォルフ	ja-JP
ゔぉるふらむ	ヴォルフラム	ja-JP
うべるたるく	ウベルタルク	ja-JP
えあゔぇるみーん	エアヴェルミーン	ja-JP
えあかると	エアカルト	ja-JP
えいねいら	エイネイラ	ja-JP
えーゔぁると	エーヴァルト	ja-JP
えーふぁ	エーファ	ja-JP
えーみーる	エーミール	ja-JP
えぐもんと	エグモント	ja-JP
えぐらんてぃーぬ	エグランティーヌ	ja-JP
えくりーれ	エクリーレ	ja-JP
えごん	エゴン	ja-JP
えっくはると	エックハルト	ja-JP
えっぼ	エッボ	ja-JP
えどぅあると	エドゥアルト	ja-JP
えなんだーく	エナンダーク	ja-JP
えなんどる	エナンドル	ja-JP
えみーりか	エミーリカ	ja-JP
えら	エラ	ja-JP
えらんとぅーら	エラントゥーラ	ja-JP
えりーあす	エリーアス	ja-JP
えるゔぃーら	エルヴィーラ	ja-JP
えるーしあ	エルーシア	ja-JP
えるねすた	エルネスタ	ja-JP
えるふりーで	エルフリーデ	ja-JP
おいさゔぁーる	オイサヴァール	ja-JP
おーでぃす	オーディス	ja-JP
おずゔぁると	オズヴァルト	ja-JP
おすゔぃん	オスヴィン	ja-JP
おっとー	オットー	ja-JP
おてぃーりえ	オティーリエ	ja-JP
おでるくんす	オデルクンス	ja-JP
おりす	オリス	ja-JP
おりすわると	オリスワルト	ja-JP
おるたんしあ	オルタンシア	ja-JP
おるとゔぃーん	オルトヴィーン	ja-JP
かーてぃす	カーティス	ja-JP
かーや	カーヤ	ja-JP
かーりん	カーリン	ja-JP
かい	カイ	ja-JP
かさんどら	カサンドラ	ja-JP
かじみあーる	カジミアール	ja-JP
かしみーる	カシミール	ja-JP
かっしーく	カッシーク	ja-JP
かてぃんか	カティンカ	ja-JP
かとらいん	カトライン	ja-JP
かとりーん	カトリーン	ja-JP
がぶりえーれ	ガブリエーレ	ja-JP
かみる	カミル	ja-JP
がらんぞるぐ	ガランゾルグ	ja-JP
かるすてっど	カルステッド	ja-JP
かるら	カルラ	ja-JP
かれん	カレン	ja-JP
かんとーな	カントーナ	ja-JP
かんふぇる	カンフェル	ja-JP
きあっふれーど	キアッフレード	ja-JP
ぎーぜるふりーと	ギーゼルフリート	ja-JP
ぎーど	ギード	ja-JP
きーらんと	キーラント	ja-JP
ぎゃりっく	ギャリック	ja-JP
ぎゅんたー	ギュンター	ja-JP
ぎる	ギル	ja-JP
きるけ	キルケ	ja-JP
ぎるべるた	ギルベルタ	ja-JP
ぐーどるーん	グードルーン	ja-JP
くいんた	クインタ	ja-JP
ぐすたふ	グスタフ	ja-JP
ぐにら	グニラ	ja-JP
くぬーと	クヌート	ja-JP
くらうでぃお	クラウディオ	ja-JP
ぐらおざむ	グラオザム	ja-JP
くらりっさ	クラリッサ	ja-JP
くらぺっひ	クラペッヒ	ja-JP
くりすてぃーね	クリスティーネ	ja-JP
くりすてる	クリステル	ja-JP
ぐりぜるだ	グリゼルダ	ja-JP
ぐりぜるだ	グリゼルダ	ja-JP
くると	クルト	ja-JP
ぐれーてぃあ	グレーティア	ja-JP
ぐれーとひぇん	グレートヒェン	ja-JP
くれーめんす	クレーメンス	ja-JP
ぐれごーる	グレゴール	ja-JP
くれめんでぃあ	クレメンディア	ja-JP
ぐろーりえ	グローリエ	ja-JP
ぐんどるふ	グンドルフ	ja-JP
げおるぎーね	ゲオルギーネ	ja-JP
げぜっつけって	ゲゼッツケッテ	ja-JP
げるだ	ゲルダ	ja-JP
けんとりぷす	ケントリプス	ja-JP
こーじも	コージモ	ja-JP
こりんな	コリンナ	ja-JP
こるどぅら	コルドゥラ	ja-JP
こるねりうす	コルネリウス	ja-JP
こんすたんつぇ	コンスタンツェ	ja-JP
こんらーでぃん	コンラーディン	ja-JP
こんらーと	コンラート	ja-JP
ざーむ	ザーム	ja-JP
ざしゃ	ザシャ	ja-JP
ざっく	ザック	ja-JP
ざるくれひと	ザルクレヒト	ja-JP
じーく	ジーク	ja-JP
じーくりんで	ジークリンデ	ja-JP
じーくれひと	ジークレヒト	ja-JP
じぇるゔぁーじお	ジェルヴァージオ	ja-JP
しきこーざ	シキコーザ	ja-JP
じぎすゔぁると	ジギスヴァルト	ja-JP
しっかーく	シッカーク	ja-JP
しどにうす	シドニウス	ja-JP
しゃるろって	シャルロッテ	ja-JP
じゃんしあーぬ	ジャンシアーヌ	ja-JP
しゅう	修	ja-JP
しゅう	しゅう	ja-JP
しゅーちゃん	しゅーちゃん	ja-JP
しゅてぃんるーく	シュティンルーク	ja-JP
しゅてるらーと	シュテルラート	ja-JP
しゅとらーる	シュトラール	ja-JP
しゅばるつ	シュバルツ	ja-JP
しゅばんくはいと	シュバンクハイト	ja-JP
しゅぼると	シュボルト	ja-JP
じょるだーの	ジョルダーノ	ja-JP
じるゔぇすたー	ジルヴェスター	ja-JP
すてふぁれーぬ	ステファレーヌ	ja-JP
せあど	セアド	ja-JP
ぜぐ	ゼグ	ja-JP
せらでぃーな	セラディーナ	ja-JP
せりむ	セリム	ja-JP
ぜるぎうす	ゼルギウス	ja-JP
ぜるてぃえ	ゼルティエ	ja-JP
そらんじゅ	ソランジュ	ja-JP
たーな	ターナ	ja-JP
だーゔぃっと	ダーヴィット	ja-JP
だーむえる	ダームエル	ja-JP
だにろ	ダニロ	ja-JP
だみあん	ダミアン	ja-JP
だんくまーる	ダンクマール	ja-JP
でぃーど	ディード	ja-JP
でぃーとりんで	ディートリンデ	ja-JP
でぃなん	ディナン	ja-JP
てぃべるた	ティベルタ	ja-JP
でぃも	ディモ	ja-JP
でぃら	ディラ	ja-JP
でぃるく	ディルク	ja-JP
でぃるみら	ディルミラ	ja-JP
てお	テオ	ja-JP
ておどーる	テオドール	ja-JP
でどりっく	デドリック	ja-JP
でりあ	デリア	ja-JP
てるつぁ	テルツァ	ja-JP
てれーじあ	テレージア	ja-JP
とぅーり	トゥーリ	ja-JP
とぅでぃーな	トゥディーナ	ja-JP
とーる	トール	ja-JP
どすたる	ドスタル	ja-JP
とっど	トッド	ja-JP
とらうごっと	トラウゴット	ja-JP
とらおくゔぁーる	トラオクヴァール	ja-JP
とるきゅーんはいと	トルキューンハイト	ja-JP
とるすてん	トルステン	ja-JP
とるでりーで	トルデリーデ	ja-JP
どるむ	ドルム	ja-JP
どれっふぁんぐーあ	ドレッファングーア	ja-JP
なーえらっひぇ	ナーエラッヒェ	ja-JP
ないぐんはいと	ナイグンハイト	ja-JP
なたーりえ	ナターリエ	ja-JP
なでぃーね	ナディーネ	ja-JP
なでぃな	ナディナ	ja-JP
なりー	ナリー	ja-JP
なんな	ナンナ	ja-JP
にこら	ニコラ	ja-JP
にこらうす	ニコラウス	ja-JP
ねーえ	ネーエ	ja-JP
ねりー	ネリー	ja-JP
のーら	ノーラ	ja-JP
のると	ノルト	ja-JP
のるべると	ノルベルト	ja-JP
はいすひっつぇ	ハイスヒッツェ	ja-JP
はいでぃ	ハイディ	ja-JP
はいでまりー	ハイデマリー	ja-JP
はいるあいんど	ハイルアインド	ja-JP
はいるりーぜ	ハイルリーゼ	ja-JP
ぱうりーね	パウリーネ	ja-JP
はすはいと	ハスハイト	ja-JP
ぱとりしあ	パトリシア	ja-JP
はーらんど	ハーランド	ja-JP
ばるつ	バルツ	ja-JP
はるとむーと	ハルトムート	ja-JP
ばるとると	バルトルト	ja-JP
ばるの	バルノ	ja-JP
はんねろーれ	ハンネローレ	ja-JP
びあす	ビアス	ja-JP
ひるしゅーる	ヒルシュール	ja-JP
ひるでぶらんと	ヒルデブラント	ja-JP
ふぁてぃーえ	ファティーエ	ja-JP
ふぃりーね	フィリーネ	ja-JP
ふーご	フーゴ	ja-JP
ふぇあぜーれ	フェアゼーレ	ja-JP
ふぇあつぃーれ	フェアツィーレ	ja-JP
ふぇい	フェイ	ja-JP
ふぇるでぃなんど	フェルディナンド	ja-JP
ふぇるねすてぃーね	フェルネスティーネ	ja-JP
ふぉるく	フォルク	ja-JP
ふぉんぜる	フォンゼル	ja-JP
ふぉんばーと	フォンバート	ja-JP
ふぉんりーど	フォンリード	ja-JP
ぶらーじうす	ブラージウス	ja-JP
ぶらう	ブラウ	ja-JP
ふらうれるむ	フラウレルム	ja-JP
ふらん	フラン	ja-JP
ふらんつぃすか	フランツィスカ	ja-JP
ふりーだ	フリーダ	ja-JP
ぶりぎって	ブリギッテ	ja-JP
ふりたーく	フリターク	ja-JP
ふりっつ	フリッツ	ja-JP
ぷりむゔぇーる	プリムヴェール	ja-JP
ぶりゅんひるで	ブリュンヒルデ	ja-JP
ふりーでりーけ	フリーデリーケ	ja-JP
ふれーでる	フレーデル	ja-JP
ふれでりか	フレデリカ	ja-JP
ふろいでん	フロイデン	ja-JP
ふろれんつぃあ	フロレンツィア	ja-JP
べいる	ベイル	ja-JP
べーぜゔぁんす	ベーゼヴァンス	ja-JP
べてぃーな	ベティーナ	ja-JP
べねでぃくた	ベネディクタ	ja-JP
べるてぃるで	ベルティルデ	ja-JP
べるとらむ	ベルトラム	ja-JP
べるのると	ベルノルト	ja-JP
へるふりーと	ヘルフリート	ja-JP
へるみーな	ヘルミーナ	ja-JP
へるるーが	ヘルルーガ	ja-JP
べるんでっと	ベルンデット	ja-JP
へんすふぇん	ヘンスフェン	ja-JP
べんどるっく	ベンドルック	ja-JP
べんの	ベンノ	ja-JP
へんりえって	ヘンリエッテ	ja-JP
へんりっく	ヘンリック	ja-JP
ぼにふぁてぃうす	ボニファティウス	ja-JP
ほれす	ホレス	ja-JP
まーゔぃん	マーヴィン	ja-JP
まいなーど	マイナード	ja-JP
まいん	マイン	ja-JP
まくしーね	マクシーネ	ja-JP
まぐだれーな	マグダレーナ	ja-JP
まちるだ	マチルダ	ja-JP
まてぃあす	マティアス	ja-JP
までぃ	マディ	ja-JP
まりあんね	マリアンネ	ja-JP
まるがれーて	マルガレーテ	ja-JP
まるく	マルク	ja-JP
まるぐりっと	マルグリット	ja-JP
まるて	マルテ	ja-JP
まるてぃな	マルティナ	ja-JP
みるだ	ミルダ	ja-JP
みろす	ミロス	ja-JP
みゅりえら	ミュリエラ	ja-JP
むれんろいえ	ムレンロイエ	ja-JP
めすてぃおのーら	メスティオノーラ	ja-JP
めるぎると	メルギルト	ja-JP
めるでぃーね	メルディーネ	ja-JP
めるひおーる	メルヒオール	ja-JP
もーりっつ	モーリッツ	ja-JP
もとす	本須	ja-JP
うらの	麗乃	ja-JP
もとすうらの	本須麗乃	ja-JP
もにか	モニカ	ja-JP
やんりっく	ヤンリック	ja-JP
ゆーでぃっと	ユーディット	ja-JP
ゆすとくす	ユストクス	ja-JP
ゆって	ユッテ	ja-JP
ゆりあーね	ユリアーネ	ja-JP
よしか	ヨシカ	ja-JP
よぜふ	ヨゼフ	ja-JP
よなさーら	ヨナサーラ	ja-JP
よはん	ヨハン	ja-JP
よるく	ヨルク	ja-JP
らーるたるく	ラールタルク	ja-JP
らいざ	ライザ	ja-JP
らいひれーぬ	ライヒレーヌ	ja-JP
らいむんと	ライムント	ja-JP
らうご	ラウゴ	ja-JP
らうら	ラウラ	ja-JP
らうれんつ	ラウレンツ	ja-JP
らおふぇれーぐ	ラオフェレーグ	ja-JP
らおぶるーと	ラオブルート	ja-JP
らおへるしゅとら	ラオヘルシュトラ	ja-JP
らぐれーて	ラグレーテ	ja-JP
らざふぁむ	ラザファム	ja-JP
らざんたるく	ラザンタルク	ja-JP
らるふ	ラルフ	ja-JP
らるふりーだ	ラルフリーダ	ja-JP
らんぷれひと	ランプレヒト	ja-JP
りあでぃな	リアディナ	ja-JP
りーゔぇす	リーヴェス	ja-JP
りーぜ	リーゼ	ja-JP
りーぜれーた	リーゼレータ	ja-JP
りーべすくひるふぇ	リーベスクヒルフェ	ja-JP
りおにー	リオニー	ja-JP
りこ	リコ	ja-JP
りさ	リサ	ja-JP
りじー	リジー	ja-JP
りずべっと	リズベット	ja-JP
りた	リタ	ja-JP
りっく	リック	ja-JP
りっくると	リックルト	ja-JP
りぬす	リヌス	ja-JP
りひと	リヒト	ja-JP
りひゃるだ	リヒャルダ	ja-JP
りゅーるらでぃ	リュールラディ	ja-JP
りゅでぃがー	リュディガー	ja-JP
りら	リラ	ja-JP
りらろーぜ	リラローゼ	ja-JP
りりー	リリー	ja-JP
りんはると	リンハルト	ja-JP
るいぽると	ルイポルト	ja-JP
るーつぃんで	ルーツィンデ	ja-JP
るーどるふ	ルードルフ	ja-JP
るーふぇん	ルーフェン	ja-JP
るーべると	ルーベルト	ja-JP
るき	ルキ	ja-JP
るすとらおね	ルストラオネ	ja-JP
るっつ	ルッツ	ja-JP
るんぐたーぜ	ルングターゼ	ja-JP
るんどざいん	ルンドザイン	ja-JP
れーあ	レーア	ja-JP
れーべれひと	レーベレヒト	ja-JP
れおのーれ	レオノーレ	ja-JP
れおん	レオン	ja-JP
れおんつぃお	レオンツィオ	ja-JP
れぎなると	レギナルト	ja-JP
れくる	レクル	ja-JP
れすてぃらうと	レスティラウト	ja-JP
れっどもんど	レッドモンド	ja-JP
れてぃーつぃあ	レティーツィア	ja-JP
れなーて	レナーテ	ja-JP
れなーとぅす	レナートゥス	ja-JP
れりぎおん	レリギオン	ja-JP
れんぐると	レングルト	ja-JP
ろいえーあ	ロイエーア	ja-JP
ろーぜまいん	ローゼマイン	ja-JP
ろーぜまりー	ローゼマリー	ja-JP
ろーたる	ロータル	ja-JP
ろーでりひ	ローデリヒ	ja-JP
ろじーな	ロジーナ	ja-JP
ろすゔぃーた	ロスヴィータ	ja-JP
ろやりてーと	ロヤリテート	ja-JP
わるでぃふりーど	ワルディフリード	ja-JP
りんくべるく	リンクベルク	ja-JP
ぐーとはいる	グートハイル	ja-JP
あんぶろす	アンブロス	ja-JP
べるねっと	ベルネット	ja-JP
めるびうす	メルビウス	ja-JP
ぐらいすと	グライスト	ja-JP
