# 2024-12-11  人名
あーでるべると	アーデルベルト	人名
あいんりーべ	アインリーベ	人名
あうれーりあ	アウレーリア	人名
あぐにーた	アグニータ	人名
あすと	アスト	人名
あだるじーざ	アダルジーザ	人名
あどるふぃーね	アドルフィーネ	人名
あどれっと	アドレット	人名
あなすたーじうす	アナスタージウス	人名
あにか	アニカ	人名
あひむ	アヒム	人名
ある	アル	人名
あるすてーで	アルステーデ	人名
あるとぅーる	アルトゥール	人名
あるのー	アルノー	人名
あるぷぜんてぃ	アルプゼンティ	人名
あるふりーだ	アルフリーダ	人名
あれくしす	アレクシス	人名
あんげりか	アンゲリカ	人名
あんぜるむ	アンゼルム	人名
あんどれあ	アンドレア	人名
いーじどーる	イージドール	人名
いぇにー	イェニー	人名
いぇにふぁー	イェニファー	人名
いえるあーと	イエルアート	人名
いぇれみあす	イェレミアス	人名
いぐなーつ	イグナーツ	人名
いざなべるた	イザナベルタ	人名
いすはいと	イスハイト	人名
いずべるが	イズベルガ	人名
いでぃりーぬ	イディリーヌ	人名
いでりーな	イデリーナ	人名
いどな	イドナ	人名
いねす	イネス	人名
いまぬえる	イマヌエル	人名
いみる	イミル	人名
いるぜ	イルゼ	人名
いるむひるで	イルムヒルデ	人名
いんご	インゴ	人名
ゔぁいす	ヴァイス	人名
ゔぁねっさ	ヴァネッサ	人名
ゔぁらまりーぬ	ヴァラマリーヌ	人名
ゔぃくとあ	ヴィクトア	人名
ゔぃるふりーと	ヴィルフリート	人名
ゔぃるま	ヴィルマ	人名
ゔぃんげると	ヴィンゲルト	人名
うーでりっく	ウーデリック	人名
ゔぇるでくらふ	ヴェルデクラフ	人名
ゔぇろーにか	ヴェローニカ	人名
ゔぇんとぅひーて	ヴェントゥヒーテ	人名
ゔぉるふ	ヴォルフ	人名
ゔぉるふらむ	ヴォルフラム	人名
うべるたるく	ウベルタルク	人名
えあゔぇるみーん	エアヴェルミーン	人名
えあかると	エアカルト	人名
えいねいら	エイネイラ	人名
えーゔぁると	エーヴァルト	人名
えーふぁ	エーファ	人名
えーみーる	エーミール	人名
えぐもんと	エグモント	人名
えぐらんてぃーぬ	エグランティーヌ	人名
えくりーれ	エクリーレ	人名
えごん	エゴン	人名
えっくはると	エックハルト	人名
えっぼ	エッボ	人名
えどぅあると	エドゥアルト	人名
えなんだーく	エナンダーク	人名
えなんどる	エナンドル	人名
えみーりか	エミーリカ	人名
えら	エラ	人名
えらんとぅーら	エラントゥーラ	人名
えりーあす	エリーアス	人名
えるゔぃーら	エルヴィーラ	人名
えるーしあ	エルーシア	人名
えるねすた	エルネスタ	人名
えるふりーで	エルフリーデ	人名
おいさゔぁーる	オイサヴァール	人名
おーでぃす	オーディス	人名
おずゔぁると	オズヴァルト	人名
おすゔぃん	オスヴィン	人名
おっとー	オットー	人名
おてぃーりえ	オティーリエ	人名
おでるくんす	オデルクンス	人名
おりす	オリス	人名
おりすわると	オリスワルト	人名
おるたんしあ	オルタンシア	人名
おるとゔぃーん	オルトヴィーン	人名
かーてぃす	カーティス	人名
かーや	カーヤ	人名
かーりん	カーリン	人名
かい	カイ	人名
かさんどら	カサンドラ	人名
かじみあーる	カジミアール	人名
かしみーる	カシミール	人名
かっしーく	カッシーク	人名
かてぃんか	カティンカ	人名
かとらいん	カトライン	人名
かとりーん	カトリーン	人名
がぶりえーれ	ガブリエーレ	人名
かみる	カミル	人名
がらんぞるぐ	ガランゾルグ	人名
かるすてっど	カルステッド	人名
かるら	カルラ	人名
かれん	カレン	人名
かんとーな	カントーナ	人名
かんふぇる	カンフェル	人名
きあっふれーど	キアッフレード	人名
ぎーぜるふりーと	ギーゼルフリート	人名
ぎーど	ギード	人名
きーらんと	キーラント	人名
ぎゃりっく	ギャリック	人名
ぎゅんたー	ギュンター	人名
ぎる	ギル	人名
きるけ	キルケ	人名
ぎるべるた	ギルベルタ	人名
ぐーどるーん	グードルーン	人名
くいんた	クインタ	人名
ぐすたふ	グスタフ	人名
ぐにら	グニラ	人名
くぬーと	クヌート	人名
くらうでぃお	クラウディオ	人名
ぐらおざむ	グラオザム	人名
くらりっさ	クラリッサ	人名
くらぺっひ	クラペッヒ	人名
くりすてぃーね	クリスティーネ	人名
くりすてる	クリステル	人名
ぐりぜるだ	グリゼルダ	人名
ぐりぜるだ	グリゼルダ	人名
くると	クルト	人名
ぐれーてぃあ	グレーティア	人名
ぐれーとひぇん	グレートヒェン	人名
くれーめんす	クレーメンス	人名
ぐれごーる	グレゴール	人名
くれめんでぃあ	クレメンディア	人名
ぐろーりえ	グローリエ	人名
ぐんどるふ	グンドルフ	人名
げおるぎーね	ゲオルギーネ	人名
げぜっつけって	ゲゼッツケッテ	人名
げるだ	ゲルダ	人名
けんとりぷす	ケントリプス	人名
こーじも	コージモ	人名
こりんな	コリンナ	人名
こるどぅら	コルドゥラ	人名
こるねりうす	コルネリウス	人名
こんすたんつぇ	コンスタンツェ	人名
こんらーでぃん	コンラーディン	人名
こんらーと	コンラート	人名
ざーむ	ザーム	人名
ざしゃ	ザシャ	人名
ざっく	ザック	人名
ざるくれひと	ザルクレヒト	人名
じーく	ジーク	人名
じーくりんで	ジークリンデ	人名
じーくれひと	ジークレヒト	人名
じぇるゔぁーじお	ジェルヴァージオ	人名
しきこーざ	シキコーザ	人名
じぎすゔぁると	ジギスヴァルト	人名
しっかーく	シッカーク	人名
しどにうす	シドニウス	人名
しゃるろって	シャルロッテ	人名
じゃんしあーぬ	ジャンシアーヌ	人名
しゅう	修	名
しゅう	しゅう	人名
しゅーちゃん	しゅーちゃん	人名
しゅてぃんるーく	シュティンルーク	人名
しゅてるらーと	シュテルラート	人名
しゅとらーる	シュトラール	人名
しゅばるつ	シュバルツ	人名
しゅばんくはいと	シュバンクハイト	人名
しゅぼると	シュボルト	人名
じょるだーの	ジョルダーノ	人名
じるゔぇすたー	ジルヴェスター	人名
すてふぁれーぬ	ステファレーヌ	人名
せあど	セアド	人名
ぜぐ	ゼグ	人名
せらでぃーな	セラディーナ	人名
せりむ	セリム	人名
ぜるぎうす	ゼルギウス	人名
ぜるてぃえ	ゼルティエ	人名
そらんじゅ	ソランジュ	人名
たーな	ターナ	人名
だーゔぃっと	ダーヴィット	人名
だーむえる	ダームエル	人名
だにろ	ダニロ	人名
だみあん	ダミアン	人名
だんくまーる	ダンクマール	人名
でぃーど	ディード	人名
でぃーとりんで	ディートリンデ	人名
でぃなん	ディナン	人名
てぃべるた	ティベルタ	人名
でぃも	ディモ	人名
でぃら	ディラ	人名
でぃるく	ディルク	人名
でぃるみら	ディルミラ	人名
てお	テオ	人名
ておどーる	テオドール	人名
でどりっく	デドリック	人名
でりあ	デリア	人名
てるつぁ	テルツァ	人名
てれーじあ	テレージア	人名
とぅーり	トゥーリ	人名
とぅでぃーな	トゥディーナ	人名
とーる	トール	人名
どすたる	ドスタル	人名
とっど	トッド	人名
とらうごっと	トラウゴット	人名
とらおくゔぁーる	トラオクヴァール	人名
とるきゅーんはいと	トルキューンハイト	人名
とるすてん	トルステン	人名
とるでりーで	トルデリーデ	人名
どるむ	ドルム	人名
どれっふぁんぐーあ	ドレッファングーア	人名
なーえらっひぇ	ナーエラッヒェ	人名
ないぐんはいと	ナイグンハイト	人名
なたーりえ	ナターリエ	人名
なでぃーね	ナディーネ	人名
なでぃな	ナディナ	人名
なりー	ナリー	人名
なんな	ナンナ	人名
にこら	ニコラ	人名
にこらうす	ニコラウス	人名
ねーえ	ネーエ	人名
ねりー	ネリー	人名
のーら	ノーラ	人名
のると	ノルト	人名
のるべると	ノルベルト	人名
はいすひっつぇ	ハイスヒッツェ	人名
はいでぃ	ハイディ	人名
はいでまりー	ハイデマリー	人名
はいるあいんど	ハイルアインド	人名
はいるりーぜ	ハイルリーゼ	人名
ぱうりーね	パウリーネ	人名
はすはいと	ハスハイト	人名
ぱとりしあ	パトリシア	人名
はーらんど	ハーランド	人名
ばるつ	バルツ	人名
はるとむーと	ハルトムート	人名
ばるとると	バルトルト	人名
ばるの	バルノ	人名
はんねろーれ	ハンネローレ	人名
びあす	ビアス	人名
ひるしゅーる	ヒルシュール	人名
ひるでぶらんと	ヒルデブラント	人名
ふぁてぃーえ	ファティーエ	人名
ふぃりーね	フィリーネ	人名
ふーご	フーゴ	人名
ふぇあぜーれ	フェアゼーレ	人名
ふぇあつぃーれ	フェアツィーレ	人名
ふぇい	フェイ	人名
ふぇるでぃなんど	フェルディナンド	人名
ふぇるねすてぃーね	フェルネスティーネ	人名
ふぉるく	フォルク	人名
ふぉんぜる	フォンゼル	人名
ふぉんばーと	フォンバート	人名
ふぉんりーど	フォンリード	人名
ぶらーじうす	ブラージウス	人名
ぶらう	ブラウ	人名
ふらうれるむ	フラウレルム	人名
ふらん	フラン	人名
ふらんつぃすか	フランツィスカ	人名
ふりーだ	フリーダ	人名
ぶりぎって	ブリギッテ	人名
ふりたーく	フリターク	人名
ふりっつ	フリッツ	人名
ぷりむゔぇーる	プリムヴェール	人名
ぶりゅんひるで	ブリュンヒルデ	人名
ふりーでりーけ	フリーデリーケ	人名
ふれーでる	フレーデル	人名
ふれでりか	フレデリカ	人名
ふろいでん	フロイデン	人名
ふろれんつぃあ	フロレンツィア	人名
べいる	ベイル	人名
べーぜゔぁんす	ベーゼヴァンス	人名
べてぃーな	ベティーナ	人名
べねでぃくた	ベネディクタ	人名
べるてぃるで	ベルティルデ	人名
べるとらむ	ベルトラム	人名
べるのると	ベルノルト	人名
へるふりーと	ヘルフリート	人名
へるみーな	ヘルミーナ	人名
へるるーが	ヘルルーガ	人名
べるんでっと	ベルンデット	人名
へんすふぇん	ヘンスフェン	人名
べんどるっく	ベンドルック	人名
べんの	ベンノ	人名
へんりえって	ヘンリエッテ	人名
へんりっく	ヘンリック	人名
ぼにふぁてぃうす	ボニファティウス	人名
ほれす	ホレス	人名
まーゔぃん	マーヴィン	人名
まいなーど	マイナード	人名
まいん	マイン	人名
まくしーね	マクシーネ	人名
まぐだれーな	マグダレーナ	人名
まちるだ	マチルダ	人名
まてぃあす	マティアス	人名
までぃ	マディ	人名
まりあんね	マリアンネ	人名
まるがれーて	マルガレーテ	人名
まるく	マルク	人名
まるぐりっと	マルグリット	人名
まるて	マルテ	人名
まるてぃな	マルティナ	人名
みるだ	ミルダ	人名
みろす	ミロス	人名
みゅりえら	ミュリエラ	人名
むれんろいえ	ムレンロイエ	人名
めすてぃおのーら	メスティオノーラ	人名
めるぎると	メルギルト	人名
めるでぃーね	メルディーネ	人名
めるひおーる	メルヒオール	人名
もーりっつ	モーリッツ	人名
もとす	本須	姓
うらの	麗乃	名
もとすうらの	本須麗乃	人名
もにか	モニカ	人名
やんりっく	ヤンリック	人名
ゆーでぃっと	ユーディット	人名
ゆすとくす	ユストクス	人名
ゆって	ユッテ	人名
ゆりあーね	ユリアーネ	人名
よしか	ヨシカ	人名
よぜふ	ヨゼフ	人名
よなさーら	ヨナサーラ	人名
よはん	ヨハン	人名
よるく	ヨルク	人名
らーるたるく	ラールタルク	人名
らいざ	ライザ	人名
らいひれーぬ	ライヒレーヌ	人名
らいむんと	ライムント	人名
らうご	ラウゴ	人名
らうら	ラウラ	人名
らうれんつ	ラウレンツ	人名
らおふぇれーぐ	ラオフェレーグ	人名
らおぶるーと	ラオブルート	人名
らおへるしゅとら	ラオヘルシュトラ	人名
らぐれーて	ラグレーテ	人名
らざふぁむ	ラザファム	人名
らざんたるく	ラザンタルク	人名
らるふ	ラルフ	人名
らるふりーだ	ラルフリーダ	人名
らんぷれひと	ランプレヒト	人名
りあでぃな	リアディナ	人名
りーゔぇす	リーヴェス	人名
りーぜ	リーゼ	人名
りーぜれーた	リーゼレータ	人名
りーべすくひるふぇ	リーベスクヒルフェ	人名
りおにー	リオニー	人名
りこ	リコ	人名
りさ	リサ	人名
りじー	リジー	人名
りずべっと	リズベット	人名
りた	リタ	人名
りっく	リック	人名
りっくると	リックルト	人名
りぬす	リヌス	人名
りひと	リヒト	人名
りひゃるだ	リヒャルダ	人名
りゅーるらでぃ	リュールラディ	人名
りゅでぃがー	リュディガー	人名
りら	リラ	人名
りらろーぜ	リラローゼ	人名
りりー	リリー	人名
りんはると	リンハルト	人名
るいぽると	ルイポルト	人名
るーつぃんで	ルーツィンデ	人名
るーどるふ	ルードルフ	人名
るーふぇん	ルーフェン	人名
るーべると	ルーベルト	人名
るき	ルキ	人名
るすとらおね	ルストラオネ	人名
るっつ	ルッツ	人名
るんぐたーぜ	ルングターゼ	人名
るんどざいん	ルンドザイン	人名
れーあ	レーア	人名
れーべれひと	レーベレヒト	人名
れおのーれ	レオノーレ	人名
れおん	レオン	人名
れおんつぃお	レオンツィオ	人名
れぎなると	レギナルト	人名
れくる	レクル	人名
れすてぃらうと	レスティラウト	人名
れっどもんど	レッドモンド	人名
れてぃーつぃあ	レティーツィア	人名
れなーて	レナーテ	人名
れなーとぅす	レナートゥス	人名
れりぎおん	レリギオン	人名
れんぐると	レングルト	人名
ろいえーあ	ロイエーア	人名
ろーぜまいん	ローゼマイン	人名
ろーぜまりー	ローゼマリー	人名
ろーたる	ロータル	人名
ろーでりひ	ローデリヒ	人名
ろじーな	ロジーナ	人名
ろすゔぃーた	ロスヴィータ	人名
ろやりてーと	ロヤリテート	人名
わるでぃふりーど	ワルディフリード	人名
りんくべるく	リンクベルク	姓
ぐーとはいる	グートハイル	姓
あんぶろす	アンブロス	姓
べるねっと	ベルネット	姓
めるびうす	メルビウス	姓
ぐらいすと	グライスト	姓
